1111111
1000001
1010101
1001101
1010001
1001101
1111111